Humble Beginnings
. . S . . . . . .
. . # . . . . . .
. . . . . . . # .
. . . . . . . . .
. . . . . . . . .
. . # # # . . . .
. . . . . . . . .
#J1 . . . . . . .
. # F #J1 . J1# .
# # # # # # # # #