Humble Beginnings
. . . . . . . . .
. . . . . . . . .
. . . . . . . . .
. . . . . . . . .
. . . . F . . . .
. . # # # # . . .
. . . . . . . . .
#J1 . . . . . . .
. # S . . . JL# .
# # # # # # # # #